#######
#.....#
#.....#
#@ox..#
#.....#
#.....#
#######