#########################
#......o...............x#
#.....@o................#
#....oo$oo..............#
#......o................#
#.....xo................#
#.......................#
#.......................#
#.......................#
#.......................#
#.......................#
#.......................#
#.......................#
#.......................#
#.......................#
#.......................#
#########################